1111111111111
100100C0000C1
1000C111C01
1P0011E000
1111