1111111111111
100100C0000C1
1000C11111C01
1P0011E010001
1111111111111