11111111111111111111111111111
10000000100000000011111111111
10111110101111111000000010001
11111110100011111111010110101
1100000011101100011001011C101
1101111110C011010110110000101
11011111101111010110111110101
11001111101100010000001110101
111000C0001101110111101110101
11101111101101110111111010101
1P001111101100110111111010101
11111111101110110000111010101
11110000101110111110100000101
11110110001000111110001111101
11000111111011100011101100001
110111000000111010111001C1111
11011101111110001011110100011
110000011100001110111101110E1
11111111111111111111111111111